Guida alla reperibilità degli elementi chimici utili


Questo file spiega dove andare a fare la faccia di cazzo perché ci diano quello che ci serve...

Acido Citrico			Limoni...(volete mica sapere da dove prendere i limoni ???:)
Acido Muriatico			Negozi di detersivi, ma è sempre in soluzione...
Acido Nitrico			Fotografi, ma dati i precedenti, è difficile che te lo diano...
Acido Solforico			Batterie auto usate (e non :)
Alcool Denaturato		Negozi di detersivi
Alcool Etilico			Negozi di Alimentari (o nelle mie vene...)
Alluminio			Carta argentata, nei negozi di Detersivi o Alimentari
Ammoniaca			Negozi di detersivi, ma la più pura si trova in Farmacia
Azoto				Consorzi agrari
Azoto Liquido			Eh eh eh... ci vuole solo un raid nei laboratori...
Butano				Gas per gli accendini, Tabaccaio
Carbone				Negozi di detersivi, Toner delle stampanti (già in polvere)
Diavolina			Negozi di detersivo o di campeggio
Etere Etilico			Farmacia, utile per pulire le corde della chitarra e del basso
Glicerina			Nelle creme, in Farmacia
Grafite				Parte scrivente delle matite
Idrogeno			Vedi File
Iodio				Farmacia
Magnesio			Farmacia, negozi di campeggio
Mercurio			Farmacia, ahime, lo potete estrarre solo dai termometri...
Nitrato di Ammonio		Consorzio agrario, Farmacia
Nitrato di Potassio		Consorzio agrario, Farmacia
Permanganato di Potassio	Farmacia, Kit contro i morsi di serpente
Potassio			Solo nei laboratori
Stronzio			A chi ? a te ! Nei catarifrangenti, quindi sulle autostrade...
Toluene				Solvente per smalto di vernice (non per unghie) Ferramenta
Zinco				Ferramenta



bRiGaDiSt